border_size=1
usage=map

Xu          , Xu          , Xu          , Xu          , Xu          , Xu          , Xu          , Xu          , Xu          , Xu          , Xu          , Xu          , Xu          , Xu          , Xu          , Xu          , Xu          , Xu          , Xu          , Xu          , Xu          , Xu          , Xu          , Xu          , Xu          , Xu          , Xu          , Xu          , Xu          , Xu          , Xu          , Xu          , Xu          , Xu          
Xu          , Xu          , Uue^Emf     , Uue^Emf     , Uue^Emf     , Uue^Emf     , Uue^Emf     , Uue^Emf     , Uue         , Uue         , Uue         , Uue^Emf     , Uue^Emf     , Xu          , Xu          , Uu^Ufi      , Uu^Ufi      , Uu^Ufi      , Uu          , Uu          , Uu          , Uu          , Uu^Br/      , Uu          , Uu          , Uh          , Uh          , Uh          , Uh          , Xu          , Uu          , Uu          , Xu          , Xu          
Xu          , Uue^Emf     , Uue^Emf     , Uue^Emf     , Wwg         , Wwg         , Wwg         , Wwg         , Wwg         , Uue         , Uue         , Uue^Br\     , Uue^Br|     , Xu          , Xu          , Uu^Ufi      , Uu          , Uu          , Uu          , Uu          , Uu          , Uu^Br/      , Uh          , Uu          , Uh          , Uh          , Uh          , Uh          , Uh          , Xu          , Xu          , Uu          , Xu          , Xu          
Xu          , Uue^Emf     , Wwg         , Wwg         , Wwg         , Wwg         , Wwg         , Wwg         , Wwg         , Wwg         , Xu          , Uue         , Uue         , Uh          , Xu          , Xu          , Xu          , Uu          , Uu^Br|      , Uu^Br/      , Uh          , Uh          , Xu          , Uh          , Uh          , Uh          , Uh          , Uh          , Xu          , Uu          , Uu          , Uu          , Uu          , Xu          
Xu          , Uue         , Wwg         , Wwg         , Wwg         , Wwg         , Wwg         , Wwg         , Xu          , Xu          , Xu          , Uue         , Uue^Br|     , Uh          , Uh          , Xu          , Xu          , Uh          , Uu^Br|      , Uu          , Xu          , Xu          , Xu          , Xu          , Xu          , Xu          , Xu          , Xu          , Xu          , Xu          , Uu          , Uu          , Uu          , Xu          
Xu          , Uue         , Uue         , Wwg         , Wwg         , Wwg         , Xu          , Xu          , Uh^Vud      , Xu          , Uue         , Uue         , Uue^Br|     , Uue         , Uh          , Xu          , Xu          , Uh          , Uh          , Xu          , Xu          , Xu          , Uh          , Cud         , Cud         , Kud         , Cud         , Xu          , Xu          , Xu          , Xu          , Uu          , Xu          , Xu          
Xu          , Xu          , Uue         , Uue         , Uue         , Xu          , Xu          , Uh          , Uh          , Uue         , Uue         , Uue         , Uue         , Uue         , Uh          , Xu          , Uh          , Uh          , Uh          , Uh          , Uh          , Uh          , Uu          , Uu          , Uu          , Cud         , Uu          , Uh          , Uh          , Xu          , Uu          , Xu          , Xu          , Xu          
Xu          , Xu          , Xu          , Uue         , Xu          , Xu          , Xu          , Xu          , Xu          , Uh          , Uue^Uf      , Uue         , Uue^Uf      , Uue^Br\     , Uue^Br\     , Uh          , Uue^Br/     , Uh          , Uh          , Uh          , Uh          , Uu          , Uh          , Uh          , Uu          , Uu          , Uu          , Uu          , Uu          , Uu          , Uh          , Uu          , Uu^Uf       , Xu          
Xu          , Xu          , Xu          , Xu          , Uh          , Uh          , Uh          , Xu          , Xu          , Xu          , Xu          , Xu          , Xu          , Xu          , Xu          , Uue^Br|     , Uue         , Xu          , Xu          , Xu          , Xu          , Uh          , Uh          , Uh          , Xu          , Uu          , Uh          , Uu          , Uh          , Uh          , Xu          , Uh          , Xu          , Xu          
Xu          , Uh          , Uh          , Uh          , Uue         , Uh          , Uue         , Uue         , Uue         , Xu          , Xu          , Xu          , Uue^Vu      , Xu          , Uue         , Uue         , Uue         , Uue         , Xu          , Xu          , Xu          , Xu          , Xu          , Uue^Vud     , Xu          , Uu          , Uu          , Uh          , Uh          , Uh          , Xu          , Xu          , Xu          , Xu          
Xu          , Uh          , Uh          , Uue         , Uh          , Uue         , Uh          , Uh          , Uh          , Uh          , Uue         , Uue         , Uue         , Uue         , Xu          , Xu          , Xu          , Uue         , Uue         , Uue         , Uue         , Xu          , Xu          , Xu          , Xu          , Uu          , Uh          , Uh          , Xu          , Xu          , Uu^Emf      , Uu^Emf      , Xu          , Xu          
Xu          , Uh          , Uh          , Uh          , Uh          , Uh          , Uh          , Uh          , Uh          , Uh          , Xu          , Uue         , Uue         , Uue^Br|     , Uh          , Xu          , Xu          , Xu          , Uh          , Uh          , Xu          , Uh          , Uh          , Xu          , Uu          , Uu          , Uu          , Uh          , Uh          , Xu          , Uu^Br/      , Uu^Emf      , Xu          , Xu          
Xu          , Uh          , Xu          , Uh          , Xu          , Uh          , Xu          , Uh          , Xu          , Xu          , Xu          , Uue         , Uue         , Uue         , Uue^Br\     , Uh          , Uh          , Xu          , Xu          , Uh          , Xu          , Xu          , Uh          , Uh          , Uu          , Uu          , Uu          , Uu^Br\      , Uu^Br/      , Uu^Br/      , Uh          , Uu          , Xu          , Xu          
Xu          , Xu          , Xu          , Xu          , Xu          , Xu          , Xu          , Xu          , Xu          , Xu          , Uue^Ii      , Uue         , Xu          , Xu          , Xu          , Uue^Br|     , Uue^Vu      , Xu          , Xu          , Uh          , Xu          , Xu          , Uh          , Uh          , Uh          , Uh          , Uh          , Uu          , Uh^Br|      , Uh          , Uh          , Uh          , Xu          , Xu          
Xu          , Xu          , Xu          , Xu          , Xu          , Xu          , Uue         , Xu          , Uh          , Xu          , Uue         , Uue^Ii      , Xu          , Xu          , Uue^Br/     , Uue^Br|     , Xu          , Xu          , Uh          , Uh          , Xu          , Xu          , Xu          , Xu          , Xu          , Xu          , Xu          , Xu          , Uh          , Xu          , Uh          , Uh          , Xu          , Xu          
Xu          , Uh^Vu       , Uh          , Uh          , Uue         , Uue         , Uh          , Uue         , Uue         , Uue         , Uue         , Uue         , Uue         , Uue^Br/     , Uue         , Uue         , Xu          , Xu          , Uue         , Uh          , Xu          , Xu          , Kud^Ii      , Cud^Ii      , Cud^Ii      , Xu          , Uue^Ii      , Xu          , Uh^Br|      , Xu          , Uh          , Uh          , Xu          , Xu          
Xu          , Uh          , Uue         , Uue^Br/     , Xu          , Uh          , Xu          , Uh          , Uh          , Uue         , Xu          , Uue         , Xu          , Uue         , Uue         , Uue         , Uue         , Uue         , Uue         , Uue         , Uue         , Xu          , Xu          , Cud^Ii      , Uue^Ii      , Uue^Ii      , Uue         , Uue         , Uue^Br|     , Xu          , Xu          , Uh          , Xu          , Xu          
Xu          , Uh          , Uue         , Uue^Br|     , Xu          , Xu          , Xu          , Xu          , Xu          , Xu          , Xu          , Xu          , Xu          , Xu          , Xu          , Xu          , Xu          , Xu          , Xu          , Uue         , Uue         , Xu          , Xu          , Uue^Ii      , Uue         , Uue         , Uue^Br/     , Uue^Br/     , Uh          , Xu          , Xu          , Uh          , Xu          , Xu          
Xu          , Xu          , Uue         , Uue^Br|     , Xu          , Xu          , Uue^Vud     , Uue^Uf      , Uue         , Xu          , Uh          , Xu          , Uh          , Uh          , Uue         , Sm^Vud      , Uue         , Xu          , Uue^Br/     , Uue         , Uue         , Uue         , Uue         , Xu          , Uue^Br/     , Uue^Br/     , Uh          , Uh          , Uh          , Xu          , Xu          , Xu          , Uue         , Xu          
Xu          , Xu          , Uue         , Uue^Br\     , Uue         , Xu          , Xu          , Uue         , Uue         , Uue         , Uue         , Uh          , Uue^Br/     , Uue^Br\     , Uue^Br\     , Uue         , Uue^Br/     , Uue         , Xu          , Xu          , Xu          , Xu          , Xu          , Uue         , Uue         , Uue         , Uh          , Uh          , Uh          , Uh          , Uue         , Uue         , Uue         , Xu          
Xu          , Xu          , Xu          , Uue         , Uue         , Uue^Br\     , Uue         , Uue         , Xu          , Uue         , Uue         , Uue^Br/     , Uh          , Uh          , Uh          , Uue^Br\     , Uue         , Uue         , Uue         , Xu          , Uue         , Uue         , Uue         , Uue         , Xu          , Xu          , Xu          , Xu          , Xu          , Uh          , Uue         , Uue         , Xu          , Xu          
Xu          , Xu          , Xu          , Xu          , Xu          , Uue         , Uue^Ii      , Xu          , Xu          , Uue         , Uh          , Uh          , Xu          , Uh          , Xu          , Xu          , Xu          , Uue         , Uue         , Uue         , Xu          , Xu          , Sm          , Uue         , Uue         , Xu          , Sm^Vud      , Xu          , Xu          , Xu          , Xu          , Uue         , Xu          , Xu          
Xu          , Xu          , Xu          , Xu          , Xu          , Uue         , Uue^Br|     , Xu          , Uue^Br/     , Uue^Br|     , Uh          , Xu          , Xu          , Xu          , Xu          , Xu          , Uue         , Xu          , Uue         , Xu          , Xu          , Xu          , Sm          , Sm          , Sm          , Uue         , Uue         , Sm          , Sm          , Sm          , Sm          , Sm          , Sm          , Xu          
Xu          , Xu          , Xu          , Xu          , Xu          , Uue^Uf      , Uue^Br\     , Uue         , Uue^Br|     , Uue         , Uh          , Xu          , Uue^Vu      , Uue         , Uue         , Uue         , Wwg         , Uue^Uf      , Wwg         , Uue^Uf      , Xu          , Xu          , Sm          , Sm          , Sm          , Uue         , Sm          , Sm          , Sm          , Sm          , Xu          , Xu          , Sm          , Xu          
Xu          , Xu          , Xu          , Xu          , Xu          , Cud         , Cud         , Uue^Br\     , Uue^Br|     , Uh          , Xu          , Xu          , Uue         , Uue         , Wwg         , Wwg         , Wwg         , Wwg         , Wwg         , Uue^Uf      , Xu          , Xu          , Xu          , Xu          , Sm          , Uue         , Xu          , Xu          , Xu          , Xu          , Xu          , Xu          , Uue         , Xu          
Xu          , Xu          , Xu          , Xu          , Xu          , Kud         , Cud         , Uue         , Uue^Br|     , Uue         , Xu          , Xu          , Uue         , Wwg         , Wwg         , Wwg         , Wwg         , Wwg         , Wwg         , Uue         , Xu          , Xu          , Sm          , Xu          , Sm          , Uue         , Xu          , Xu          , Xu          , Xu          , Uue         , Uue         , Uue^Vu      , Xu          
Xu          , Xu          , Xu          , Xu          , Xu          , Xu          , Xu          , Uue         , Uue^Br|     , Uue         , Xu          , Uue^Emf     , Uue^Emf     , Wwg         , Wwg         , Wwg         , Uue^Emf     , Wwg         , Uue^Emf     , Uue         , Uue         , Xu          , Sm          , Sm          , Sm          , Uue         , Sm          , Sm          , Sm          , Uue         , Uue         , Uue         , Uue         , Xu          
Xu          , Xu          , Xu          , Xu          , Xu          , Xu          , Xu          , Uue         , 1 Uue^Br|   , Uue         , Xu          , Uue^Emf     , Xu          , Uue^Emf     , Xu          , Uue^Emf     , Xu          , Uue^Emf     , Xu          , Uue         , Uue         , Sm          , Xu          , Sm          , Xu          , Sm          , Xu          , Sm          , Xu          , Xu          , Xu          , Uue         , Xu          , Xu          
Xu          , Xu          , Xu          , Xu          , Xu          , Xu          , Xu          , Uue^Ii      , Uue^Ii      , Uue^Ii      , Xu          , Xu          , Xu          , Xu          , Xu          , Xu          , Xu          , Xu          , Xu          , Xu          , Xu          , Xu          , Xu          , Xu          , Xu          , Xu          , Xu          , Xu          , Xu          , Xu          , Xu          , Xu          , Xu          , Xu          
