border_size=1
usage=map

Gs^Fp       , Gs^Fp       , Gg          , Gg          , Gg          , Gg          , Gg          , Gg          , Gg          , Gs^Fp       , Gs^Fp       , Ss^Fp       , Ww          , Mm          , Ms          , Ai          , Ai          , Ai          , Ai          , Ms          , Ms          , Rr          , Rr          , Aa          , Aa          , Ha          , Ha          , Ww          
Rr          , Rr          , Rr          , Gg^Vwm      , Gg          , Gs          , Gs^Gvs      , Gg^Gvs      , Gg^Gvs      , Gg          , Gs^Fp       , Ss^Fp       , Ww^Ewf      , Ha          , Ms          , Ai          , Ai          , Ai          , Ai          , Ms          , Ha^Fma      , Aa          , Aa          , Rr          , Aa          , Ha          , Ww          , Ww          
Gd          , Gd          , Gg          , Rr          , Gg^Eff      , Gs^Gvs      , Gs^Gvs      , Gg^Gvs      , Gg^Gvs      , Gg^Gvs      , Gg^Eff      , Ss^Fp       , Ww          , Ha          , Ms          , Ms          , Ms          , Ms          , Ms          , Ms          , Ha^Fma      , Aa^Fma      , Coa         , Rr          , Coa         , Ha^Fpa      , Ww          , Ai          
Gd          , Gd          , Gg          , Rr          , Gg          , Gs^Eff      , Gs^Eff      , Gs^Gvs      , Gg^Eff      , Gg^Eff      , Gs^Fp       , Ss          , Ww          , Ha          , Ha          , Ha          , Ha^Fma      , Ha          , Ha          , Ha^Fma      , Ha^Fma      , Aa^Fma      , Rr          , Rr          , Aa^Fma      , Ha^Fpa      , Ai          , Ww          
Gd          , Gd          , Gd          , Ch          , Ch          , Ch          , Gg          , Gs^Eff      , Gg          , Gd          , Gg          , Chr         , Ww^Ewf      , Ss^Fp       , Ss^Fp       , Gs^Fp       , Gs^Fp       , Gs^Fp       , Gs^Fp       , Gs^Fp       , Gs^Fp       , Gs^Fp       , Rr          , Gs^Fp       , Gd^Vo       , Gs^Fp       , Ww          , Ww          
Aa          , Gd          , Gd          , Ch          , 1 Kh        , Ch          , Gg          , Gg          , Gg          , Gd          , Gg          , Hh^Fms      , Hh^Vhh      , Ww          , Gs^Fp       , Gs^Fp       , Gs^Fp       , Gs^Fp       , Gs^Fp       , Gs^Fp       , Gs^Fp       , Rr          , Gs^Fp       , Gs^Fp       , Gs^Fp       , Gs^Fp       , Ww          , Xu          
Aa          , Gd          , Gd          , Gg          , Rr          , Gg          , Gg          , Gg^Es       , Gs^Fp       , Gs          , Gs          , Hh^Fms      , Hh^Fms      , Ww          , Gs^Fp       , Gg          , Ss          , Gs^Fp       , Gs^Fp       , Gs^Fp       , Gg          , Rr          , Sm^Fp       , Sm          , Ww          , Ww          , Ww          , Xu          
Gg          , Gd          , Gg          , Gg^Efm      , Rr          , Gg          , Gs^Fp       , Gs^Fp       , Hh^Fms      , Hh^Fms      , Hh^Fms      , Hh^Fms      , Chr^Fp      , Ww          , Gg^Ve       , Gs^Fp       , Gs^Fp       , Gs^Fp       , Gs^Fp       , Gg          , Gs^Fp       , Gg          , Sm^Fp       , Sm^Fp       , Ww          , Ww          , Xu          , Xu          
Gg          , Gg          , Gg          , Gg          , Rr          , Gg          , Gs^Fp       , Rr^Vhc      , Hh^Fms      , Hh^Fms      , Chr         , Hh^Fms      , Md          , Ww          , Ww          , Gs^Fp       , Ww          , Gg          , Sm          , Sm          , Sm          , Sm          , Sm          , Sm          , Ww          , Xu          , Uu^Vud      , Xu          
Gg          , Gg^Efm      , Gs^Vh       , Gg          , Gg          , Rr          , Gs^Fp       , Hh^Fms      , Hh^Fms      , Chr         , Hh          , Hh          , Md          , Hh          , Ww          , Ww          , Gd          , Ww          , Ww          , Sm          , Ww          , Ww          , Ww          , Ww          , Xu          , Xu          , Ur          , Xu          
Gg          , Ww          , Gg          , Gg          , Ch          , Rr          , Ch          , Gs^Fp       , Hh          , Hh          , Md          , Md          , Hh          , Hh          , Hh          , Hh          , Gd^Es       , Gd^Es       , Ww          , Ww          , Xu          , Xu          , Xu          , Xu          , Uu^Vu       , Xu          , Ur          , Xu          
Ww          , Ww          , Ai          , Ai          , Ww          , Ww^Bw|      , Ww          , Gs^Fp       , Hh^Fms      , Md          , Hh          , Hh          , Gd          , Gd^Fdw      , Gd          , Gd^Fdw      , Gd^Es       , Gd^Fdw      , Ww          , Xu          , Uu          , Uu^Vu       , Xu          , Uh          , Ur          , Ur          , Xu          , Xu          
Ww          , Ww          , Ww          , Ww          , Ww          , Rr          , Ww^Ewl      , Ww          , Ww          , Hh^Fms      , Gd^Fdw      , Gd          , Gd^Fdw      , Gd^Es       , Gd^Fdw      , Gd          , Gd^Fdw      , Hhd^Fdw     , Ww          , Xu          , Uu^Uf       , Ur          , Xu          , Uh          , Ur          , Uu          , Uu^Uf       , Xu          
Ww          , Ww          , Ww          , Ww          , Ww          , Rr          , Rr          , Gs^Fp       , Ww          , Ww          , Gd^Vhc      , Gd^Fdw      , Gd^Fdw      , Gd^Es       , Gd^Fdw      , Gd^Dr       , Gd^Fdw      , Hhd^Fdw     , Ww          , Xu          , Uu          , Ur          , Co          , Xu          , Ur          , Uu          , Uu^Uf       , Xu          
Ai          , Ww^Vm       , Ww          , Ww          , Ww          , Hh          , Gs^Vh       , Rr          , Gg^Em       , Ww          , Ww          , Ww          , Gd          , Gd          , Gd          , Gd^Fdw      , Gd^Fdw      , Ww          , Xu          , Ur          , Ur          , Ur          , Ur          , Ur          , Xu          , Uu          , Xu          , Xu          
Ai          , Ai          , Ai          , Ai          , Ai          , Hh          , Hh^Fp       , Rr          , Rr          , Gg          , Gs^Fdw      , Ww          , Gd^Emf      , Gd          , Gd^Em       , Gd^Fdw      , Gd^Vud      , Ww          , Xu          , Xu          , Xu          , Xu          , Uu^Uf       , Ur          , Ur          , Xu          , Xu          , Xu          
Mm          , Mm          , Mm          , Mm          , Mm          , Hh          , Hh^Fp       , Gg          , Rr          , Gs^Fdw      , Ww          , Ww          , Ww          , Gd^Emf      , Ww          , Ww          , Ww          , Ww          , Xu          , Uu^Vo       , Uu          , Co          , Xu          , Ur          , Uu^Vu       , Ur          , Ur          , Xu          
Mm          , Mm          , Mm          , Mm          , Mm          , Hh          , Hh^Fp       , Gg          , Rr          , Gs^Fdw      , Ww          , Wo          , Wo          , Ww          , Ww          , Ww          , Xu          , Xu          , Uu          , Ur          , Ur          , Ur          , Ur          , Xu          , Xu          , Xu          , Ur          , Xu          
Hh          , Hh          , Hh          , Hh          , Hh          , Hh          , Gd          , Cv          , Rr          , Gs^Fdw      , Gs^Fdw      , Wo          , Wo          , Ww          , Xu          , Xu          , Co          , Uu^Emf      , Ur          , Ur          , Xu          , Xu          , Xu          , Ur          , Ur          , Ur          , Uu^Emf      , Xu          
Gd          , Cv          , Cv          , Kv          , Cv          , Gg          , Gd          , Gd          , Rr          , Gs^Fdw      , Gs^Fdw      , Ww          , Wo          , Xu          , Xu          , Co          , 2 Ko        , Co          , Co          , Xu          , Uh          , Uu^Vo       , Xu          , Xu          , Ur          , Uu          , Uu^Emf      , Xu          
Gd          , Cv          , Gd          , Cv          , Cv          , Gd          , Gd          , Gd^Vl       , Rr          , Gd          , Gd          , Ww          , Ww          , Xu          , Xu          , Co          , Co          , Co          , Xu          , Xu          , Uh          , Ur          , Ur          , Ur          , Uh          , Ur          , Uu^Vu       , Xu          
Gd          , Gd          , Gd          , Gd          , Gd          , Gd          , Gd          , Gd          , Rr          , Gd          , Gd          , Ww          , Ww          , Xu          , Xu          , Xu          , Xu          , Xu          , Xu          , Xu          , Xu          , Xu          , Xu          , Xu          , Xu          , Xu          , Xu          , Xu          
