border_size=1
usage=map

Ms          , Mm          , Ms          , Ms          , Ms          , Ms          , Ms          , Ms^Xm       , Ms^Xm       , Ha          , Ha          , Aa          , Aa          , Rd          , Rd          , Rd          , Rd          , Hhd         , Hhd         , Hhd         , Hhd         , Hhd         , Aa          , Aa          , Rd          , Re          , Rd          , Rd          , Gll^Fp      , Gll^Fp      , Gll^Fp      , Gll^Fp      
Ms          , Ms          , Ha          , Ha          , 2 Kea       , Ha          , Ms          , Ms^Xm       , Ms          , Ms          , Ha          , Aa          , Aa          , Aa          , Aa          , Rd          , Rd          , Aa^Fpa      , Aa^Fpa      , Hhd         , Ha          , Hhd         , Aa          , Aa          , Rd^Es       , Re          , Rd          , Rd          , Aa^Voa      , Aa^Fpa      , Gll^Fp      , Aa^Fpa      
Ms          , Ha          , Aa^Fpa      , Cea         , Cea         , Ha          , Ha^Vhha     , Ha          , Ms          , Ha          , Ha          , Aa          , Aa          , Aa          , Aa          , Aa^Fpa      , Aa^Fpa      , Aa^Fpa      , Aa^Fpa      , Ha          , Ha          , Ha          , Ha          , Aa          , Rd^Es       , Re          , Rd          , Aa          , Aa^Fpa      , Aa^Fpa      , Aa^Fpa      , Aa^Fpa      
Ms          , Aa^Fpa      , Aa^Fpa      , Cea         , Cea         , Aa^Fpa      , Aa^Fpa      , Ha          , Ha          , Ha          , Ha          , Ha          , Aa^Fpa      , Aa^Fpa      , Aa^Fpa      , Aa^Fpa      , Aa^Fpa      , Aa^Fpa      , Aa^Fpa      , Ha          , Ha          , Aa^Fpa      , Aa          , Aa          , Rd^Es       , Re          , Rd          , Rd          , Rd          , Rd          , Aa^Fpa      , Aa^Fpa      
Aa^Fpa      , Aa^Fpa      , Aa^Fpa      , Aa^Fpa      , Aa^Fpa      , Aa^Fpa      , Re          , Aa^Fpa      , Ha          , Ha          , Ha^Fda      , Ha^Fda      , Aa^Fpa      , Aa^Fpa      , Aa^Fpa      , Aa^Fpa      , Aa^Fpa      , Aa^Fpa      , Aa^Fpa      , Aa^Fpa      , Aa^Fpa      , Aa^Fpa      , Aa^Fpa      , Aa^Fpa      , Rd^Es       , Re          , Rd          , Rd          , Aa          , Aa          , Aa^Fpa      , Aa^Fpa      
Aa^Fpa      , Aa^Fpa      , Aa^Fpa      , Aa^Fpa      , Aa^Fpa      , Aa^Fpa      , Aa^Fpa      , Aa^Fpa      , Ha^Fda      , Ha          , Ha^Fda      , Ha^Fda      , Ha^Fda      , Aa^Fpa      , Aa^Vca      , Aa^Fpa      , Aa^Fpa      , Aa          , Aa          , Aa^Fpa      , Aa^Fpa      , Aa^Fpa      , Aa^Fpa      , Aa^Fpa      , Aa^Fpa      , Re          , Rd          , Aa          , Aa          , Aa^Fpa      , Aa^Fpa      , Aa^Fpa      
Aa^Fpa      , Aa^Fpa      , Aa^Fpa      , Aa^Fpa      , Aa^Vha      , Aa^Fpa      , Re          , Aa^Fpa      , Aa^Fpa      , Ha^Fda      , Ha^Fda      , Ha^Fda      , Aa^Fpa      , Aa^Fpa      , Aa^Fpa      , Aa          , Aa          , Aa^Fpa      , Aa^Fpa      , Aa^Fpa      , Aa^Fpa      , Aa^Fpa      , Aa^Fpa      , Aa^Fpa      , Aa^Fpa      , Re          , Rd          , Aa          , Aa^Fpa      , Aa^Fpa      , Ha^Fda      , Ha^Fda      
Aa^Fpa      , Aa^Fpa      , Aa^Fpa      , Aa^Fpa      , Aa          , Re          , Aa          , Aa          , Re          , Aa^Fpa      , Aa^Fpa      , Aa^Fpa      , Aa^Fpa      , Aa^Fpa      , Aa^Fpa      , Aa^Fpa      , Aa^Fpa      , Aa^Fpa      , Aa^Fpa      , Aa          , Aa^Fpa      , Aa^Fpa      , Aa^Fpa      , Aa^Fpa      , Aa^Fpa      , Aa^Fpa      , Rd          , Rd^Fp       , Rd          , Rd^Fp       , Ha^Fda      , Ha^Fda      
Aa^Fpa      , Aa^Fpa      , Aa^Fpa      , Aa^Fpa      , Aa^Fpa      , Aa          , Aa^Fpa      , Aa^Fpa      , Aa^Fpa      , Aa^Fpa      , Aa          , Aa^Fpa      , Aa^Vha      , Aa^Fpa      , Ha^Fpa      , Aa^Fpa      , Ha^Fpa      , Aa^Fpa      , Ha^Fpa      , Aa^Fpa      , Aa^Fpa      , Aa          , Aa^Fpa      , Aa^Voa      , Aa^Fpa      , Re          , Re          , Rd          , Rd          , Rd          , Ha^Fda      , Ha^Fda      
Aa^Fpa      , Aa^Fpa      , Aa^Fpa      , Aa^Fpa      , Aa^Fpa      , Aa^Fpa      , Aa^Fpa      , Aa^Fpa      , Aa^Fpa      , Aa^Fpa      , Aa^Fpa      , Aa          , Aa^Fpa      , Aa^Fpa      , Ha^Fpa      , Ha^Fpa      , Ha^Fpa      , Ha^Fpa      , Ha^Fpa      , Ha^Fpa      , Aa^Fpa      , Aa^Fpa      , Re          , Re          , Re          , Re          , Rd^Fp       , Rd          , Rd          , Rd          , Ha^Fda      , Ms          
Aa^Fpa      , Aa^Fpa      , Aa^Fpa      , Aa^Fpa      , Aa^Fpa      , Aa^Fpa      , Aa^Fpa      , Aa^Fpa      , Aa^Fpa      , Aa^Fpa      , Aa^Fpa      , Aa^Fpa      , Ha^Fpa      , Ha^Fpa      , Ha^Fpa      , Ms^Xm       , Ha^Fpa      , Ha^Fpa      , Ha^Fpa      , Aa^Fpa      , Aa^Fpa      , Aa          , Aa^Fpa      , Aa^Fpa      , Rd          , Aa^Fpa      , Aa^Vha      , Rd^Fp       , Rd^Fp       , Ha^Fda      , Ha^Fda      , Ms          
Aa^Fpa      , Aa^Fpa      , Aa          , Aa          , Aa^Fpa      , Aa^Fpa      , Aa^Fpa      , Aa^Fpa      , Aa^Fpa      , Aa^Fpa      , Aa^Fpa      , Ha^Fpa      , Ha^Fpa      , Ha^Fpa      , Ha^Fpa      , Ha^Fpa      , Ha^Fpa      , Ha^Fpa      , Aa^Fpa      , Aa^Fpa      , Aa          , Aa          , Aa^Fpa      , Aa^Fpa      , Aa^Fpa      , Rd          , Aa^Fpa      , Aa^Fpa      , Aa^Fpa      , Aa^Fpa      , Ha^Fda      , Ha          
Re          , Aa^Fpa      , Aa^Fpa      , Aa^Fpa      , Aa^Fpa      , Aa^Fpa      , Aa^Fpa      , Aa^Fpa      , Aa^Fpa      , Aa^Fpa      , Aa^Fpa      , Aa^Fpa      , Ha^Fpa      , Ha^Fpa      , Ha^Fpa      , Ha^Fpa      , Ha^Fpa      , Ha^Fpa      , Aa          , Aa          , Aa^Fpa      , Aa^Fpa      , Aa^Fpa      , Aa^Fpa      , Aa^Fpa      , Aa^Fpa      , Aa^Fpa      , Aa^Fpa      , Aa^Fpa      , Ha^Fpa      , Ha^Fpa      , Ha^Fda      
Re          , Re          , Aa^Fpa      , Aa^Fpa      , Aa^Fpa      , Aa^Vha      , Aa^Fpa      , Aa          , Aa^Fpa      , Aa^Fpa      , Aa^Fpa      , Aa^Fpa      , Aa^Fpa      , Ha^Fpa      , Aa^Fpa      , Aa^Fpa      , Re          , Re^Es       , Aa^Fpa      , Aa^Vha      , Aa^Fpa      , Aa^Fpa      , Aa^Fpa      , Aa^Fpa      , Aa^Fpa      , Aa^Fpa      , Aa^Fpa      , Aa^Fpa      , Aa          , Ha^Fpa      , Ha^Fpa      , Re          
Re          , Re          , Aa^Fpa      , Aa^Fpa      , Aa^Fpa      , Aa^Fpa      , Aa^Fpa      , Aa          , Aa^Fpa      , Aa^Fpa      , Aa^Fpa      , Aa^Fpa      , Aa^Fpa      , Aa^Fpa      , Re          , Re          , Aa^Fpa      , Re          , Aa          , Aa^Fpa      , Aa^Fpa      , Aa^Fpa      , Aa^Fpa      , Aa^Fpa      , Rd          , Aa^Vha      , Aa^Fpa      , Aa^Fpa      , Ha^Fpa      , Ha^Fpa      , Ha^Fpa      , Re          
Re          , Re          , Re          , Aa^Fpa      , Aa^Fpa      , Aa^Fpa      , Aa^Fpa      , Aa^Fpa      , Aa^Fpa      , Aa^Fpa      , Aa          , Aa^Fpa      , Re          , Re          , Aa^Fpa      , Aa^Fpa      , Aa^Fpa      , Aa^Fpa      , Aa^Fpa      , Aa          , Re          , Aa^Fpa      , Aa^Fpa      , Aa^Fpa      , Aa^Fpa      , Aa^Fpa      , Aa^Fpa      , Ha^Fpa      , Ha^Fpa      , Ha^Fpa      , Aa^Fpa      , Re          
Aa          , Aa          , Re          , Aa^Fpa      , Aa^Fpa      , Aa          , Aa          , Aa^Fpa      , Aa^Fpa      , Aa^Fpa      , Aa^Fpa      , Aa          , Aa^Fpa      , Aa^Fpa      , Aa^Fpa      , Aa^Fpa      , Aa^Fpa      , Aa^Fpa      , Aa^Fpa      , Aa^Fpa      , Aa^Fpa      , Aa          , Re          , Aa^Fpa      , Aa^Fpa      , Aa^Fpa      , Aa^Fpa      , Ha^Fpa      , Ha^Fpa      , Ha^Fpa      , Aa^Fpa      , Re          
Re          , Re          , Aa^Fpa      , Aa^Fpa      , Aa^Fpa      , Aa^Fpa      , Aa^Fpa      , Aa^Fpa      , Re          , Aa^Fpa      , Aa          , Aa          , Aa          , Aa^Fpa      , Aa          , Aa^Fpa      , Aa          , Aa^Fpa      , Aa^Fpa      , Aa^Fpa      , Aa^Fpa      , Aa^Fpa      , Aa^Fpa      , Re          , Re          , Aa^Fpa      , Aa^Fpa      , Ha^Fpa      , Aa^Fpa      , Aa^Fpa      , Re          , Re          
Re          , Aa          , Aa^Fpa      , Aa^Fpa      , Aa^Fpa      , Re          , Re          , Aa^Fpa      , Re          , Aa^Fpa      , Aa^Vha      , Gd          , Gd          , Aa^Fpa      , Aa          , Aa          , Aa          , Aa          , Aa^Fpa      , Aa^Fpa      , Aa^Fpa      , Aa^Fpa      , Aa^Fpa      , Aa^Fpa      , Aa^Fpa      , Aa          , Aa          , Aa^Fpa      , Re          , Re          , Aa          , Aa          
Re          , Aa          , Aa^Fpa      , Aa^Fpa      , Aa^Fpa      , Aa^Fpa      , Aa          , Re          , Gd          , Aa^Fpa      , Aa^Fpa      , Aa^Fpa      , Aa^Fpa      , Aa^Fpa      , Aa^Fpa      , Aa          , Aa          , Aa^Fpa      , Aa^Fpa      , Aa^Fpa      , Aa^Fpa      , Aa^Fpa      , Rd          , Rd          , Aa^Fpa      , Aa^Fpa      , Aa^Fpa      , Re          , Re          , Aa^Fpa      , Aa          , Aa          
Re          , Aa          , Aa          , Aa^Fpa      , Aa^Fpa      , Aa^Fpa      , Gd          , Re          , Aa^Fpa      , Aa^Fpa      , Aa^Fpa      , Aa^Fpa      , Aa^Fpa      , Aa^Fpa      , Aa^Fpa      , Aa          , Aa          , Aa          , Aa^Fpa      , Aa^Fpa      , Aa^Fpa      , Aa^Voa      , Aa^Fpa      , Rd          , Aa^Fpa      , Aa^Fpa      , Aa^Fpa      , Aa^Fpa      , Aa^Fpa      , Re          , Aa          , Aa          
Aa          , Aa          , Gd          , Aa          , Cea         , Cea         , Cea         , Re          , Aa^Fpa      , Aa^Fpa      , Aa^Fpa      , Aa          , Aa          , Aa^Fpa      , Aa          , Aa          , Aa          , Aa^Fpa      , Aa^Fpa      , Aa^Fpa      , Aa^Fpa      , Aa^Fpa      , Aa^Fpa      , Rd          , Aa^Fpa      , Aa^Fpa      , Aa^Fpa      , Aa^Fpa      , Aa^Fpa      , Re          , Re          , Aa          
Aa          , Aa^Fpa      , Aa^Fpa      , Gd          , Cea         , Kea         , Gd          , Gd^Vh       , Aa^Fpa      , Aa^Fpa      , Aa^Fpa      , Aa          , Aa          , Aa^Fpa      , Aa          , Aa          , Aa^Fpa      , Aa^Fpa      , Aa^Fpa      , Aa^Fpa      , Aa^Fpa      , Aa^Fpa      , Aa^Fpa      , Aa^Fpa      , Aa^Fpa      , Aa^Fpa      , Aa^Fpa      , Aa^Fpa      , Aa^Fpa      , Aa^Fpa      , Re          , Aa          
Aa^Fpa      , Aa^Fpa      , Aa^Fpa      , Aa^Fpa      , Re          , Gd          , Aa^Fpa      , Aa^Fpa      , Aa^Fpa      , Aa^Fpa      , Aa^Vha      , Aa          , Aa^Fpa      , Aa^Fpa      , Aa^Fpa      , Aa^Fpa      , Aa^Fpa      , Aa^Fpa      , Aa^Fpa      , Aa^Fpa      , Aa^Fpa      , Aa          , Aa^Fpa      , Aa^Fpa      , Aa^Fpa      , Aa          , Aa          , Aa          , Aa          , Aa^Fpa      , Ha          , Re          
Aa^Fpa      , Aa^Vhr      , Aa^Fpa      , Aa          , Re          , Gd          , Aa          , Aa^Fpa      , Aa^Fpa      , Gd          , Aa          , Aa^Fpa      , Aa^Fpa      , Aa^Fpa      , Aa          , Aa          , Aa^Fpa      , Aa^Fpa      , Aa^Fpa      , Aa^Fpa      , Ha          , Ha          , Ha          , Ha          , Aa^Fpa      , Aa^Fpa      , Ha^Fpa      , Ha          , Ha^Fpa      , Ha          , Ha          , Ha          
Aa          , Aa^Fpa      , Aa^Fpa      , Aa          , Gd          , Re          , Gd          , Aa          , Aa          , Aa          , Aa          , Aa          , Aa          , Aa^Fpa      , Aa          , Aa          , Aa^Fpa      , Aa^Fpa      , Aa^Fpa      , Ha          , Ms          , Ms^Xm       , Ms^Xm       , Ms          , Ha^Fpa      , Aa^Fpa      , Aa^Fpa      , Aa^Fpa      , Cea         , Ha^Fpa      , Aa          , Aa          
Aa^Fpa      , Aa^Fpa      , Aa^Fpa      , Aa^Fpa      , Gd          , 1 Re        , Gd          , Gd          , Aa          , Aa          , Aa          , Aa          , Aa^Fpa      , Aa          , Aa          , Aa          , Aa^Fpa      , Aa^Fpa      , Ha          , Ha          , Ms          , Ms^Xm       , Ms^Xm       , Ms          , Ha          , Ha^Fpa      , Cea         , Cea         , Cea         , Ha^Fpa      , Ha^Fpa      , Ha          
Aa^Fpa      , Aa^Fpa      , Aa          , Gd          , Re          , Re          , Gd          , Gd          , Aa          , Aa          , Aa          , Aa^Fpa      , Ai          , Ai          , Aa          , Aa^Fpa      , Aa^Fpa      , Aa^Vaa      , Ha          , Ha          , Ms          , Ms^Xm       , Ms^Xm       , Ms          , Ha          , Ha          , Ha          , 3 Kea       , Ha          , Ha^Fpa      , Ha          , Ha          
Aa^Fpa      , Aa          , Aa          , Gd          , Re          , Gd^Vhr      , Aa^Fpa      , Aa^Fpa      , Aa^Fpa      , Aa^Fpa      , Aa^Fpa      , Aa^Fpa      , Aa^Fpa      , Ai          , Aa          , Aa^Fpa      , Aa          , Aa          , Ha          , Ms          , Ms          , Ms          , Ms          , Ms          , Ha          , Ha          , Ha          , Ha          , Ms          , Ms          , Ha          , Ha          
Gll^Fp      , Aa          , Gd          , Gd          , Re          , Gll^Fp      , Gll^Fp      , Gll^Fp      , Gll^Fp      , Aa^Fpa      , Gd          , Gll^Fp      , Gd          , Aa          , Aa          , Aa          , Aa          , Aa          , Hhd         , Ms          , Ms          , Ms          , Ms^Xm       , Ha          , Aa^Voa      , Ha          , Ms^Xm       , Ms          , Ms          , Ms          , Ms          , Ms          
Gll^Fp      , Gll^Fp      , Gll^Fp      , Gll^Fp      , Re          , Gll^Fp      , Gd          , Gll^Fp      , Gd          , Gd          , Gd          , Gll^Fp      , Aa^Fpa      , Gd          , Gd          , Aa          , Aa          , Aa          , Hhd         , Hhd         , Ms          , Ms^Xm       , Ms^Xm       , Ms^Xm       , Ms^Xm       , Ms^Xm       , Ms^Xm       , Ms^Xm       , Ms^Xm       , Ms          , Ms          , Ms          
