border_size=1
usage=map

Gs          , Gs          , Gs          , Gs          , Gs^Fms      , Gs          , Gs          , Gs          , Gs          , Ww          , Ww          , Gs          , Gs          , Gs          , Ww          , Gs          , Ww          , Ww          , Ww          , Gs          , Gs          , Ww          , Ww          , Gs          , Ww          , Gs          , Gs          , Gs^Fp       , Gs          , Ww          , Ww          , Gg          , Ww          , Gg          
Gs^Fms      , Gs^Fms      , Gs^Fms      , Gs^Fms      , Gg          , Gs^Fms      , Gs^Fms      , Gs^Fms      , Gs^Fms      , Gs          , Gs^Fms      , Ww          , Ww          , Ww          , Ww          , Ww          , Gs          , Gs          , Gs          , Ww          , Ww          , Ww          , Ww          , Ww          , Ww          , Gs          , Gs^Fp       , Ww          , Ww          , Ww          , Gs^Fp       , Ww          , Ww          , Ww          
Gg          , Gs^Fms      , Gs          , Gs^Fms      , Ww          , Gg          , Ww          , Gs          , Gs          , Gs^Fms      , Gs^Fms      , Gs          , Gs          , Gg^Vhh      , Gs          , Gs^Fms      , Gs^Fms      , Gs^Fms      , Gs^Fms      , Gs^Fms      , Gs          , Gs          , Ww          , Gs^Vhc      , Gs          , Ww          , Ww          , Ww          , Gg          , Ww          , Gs^Fp       , Gs^Fp       , Ww          , Ww          
Ww          , Gs^Fms      , Gs^Efm      , Ww          , Ww          , Ww          , Ww          , Ww          , Ww          , Gs          , Gs          , Gs^Fms      , Gs          , Gs          , Ww          , Ww          , Ww          , Gs^Fms      , Gs^Fms      , Gs^Fms      , Gs          , Gs          , Ww          , Gs          , Gs          , Gs^Fp       , Gs          , Gs          , Ce          , Ce          , Gs^Fp       , Gs^Fp       , Gs^Fp       , Gs^Fp       
Ww          , Gs          , Gs^Efm      , Ww          , Gg          , Gg          , Gg          , Gg^Efm      , Ww          , Ww          , Gg^Vhh      , Gs          , Gs          , Ww          , Gs^Efm      , Gs          , Gs          , Ww          , Ww          , Ww          , Ww          , Ww          , Gs          , Gs          , Gs          , Gs          , Gs          , Ce          , 1 Ke        , Ce          , Gs^Fp       , Gs^Fp       , Gs^Fp       , Gs^Fp       
Ww          , Gs^Vhh      , Ww          , Ww          , Gg          , Gg          , Gs^Fds      , Gg          , Gg^Efm      , Ww          , Ww          , Ww          , Ww          , Ww          , Gs^Efm      , Gs^Fms      , Gs          , Ww          , Ww          , Gs^Vhc      , Gs          , Gs          , Gs          , Gs          , Gs          , Gs          , Rr          , Ce          , Rr          , Ce          , Gs          , Gs          , Gs          , Gs^Fp       
Gg          , Ww          , Gs^Fds      , Gg^Vhh      , Gg          , Gs^Fds      , Gs^Fds      , Gg          , Gg^Efm      , Ww          , Ww          , Ww          , Ww          , Ww          , Gs          , Gs^Fms      , Gs^Fms      , Gs          , Gs          , Gs          , Gs^Fms      , Gs          , Gs^Fms      , Gs^Fms      , Gs          , Rr          , Gs          , Rr          , Gs          , Gs          , Gs^Fms      , Gs          , Gs          , Gs^Fp       
Gs^Fds      , Gs^Fds      , Gs^Fds      , Gg          , Gs^Fds      , Gg          , Gs^Fds      , Gg          , Gg^Vhh      , Ww          , Ww          , Wwr         , Ww          , Ww          , Gs          , Gs^Fms      , Gs^Fms      , Gs          , Gs          , Gs^Fms      , Gs^Fms      , Gs^Fms      , Gs^Fms      , Gs^Fms      , Rr          , Rr          , Gs          , Gs          , Gs^Fms      , Gs^Fms      , Gs^Fms      , Gs^Fms      , Gd          , Gd          
Gg          , Gg          , Gs^Fds      , Gs^Fds      , Gs^Fds      , Gs^Fds      , Gs^Fds      , Gg          , Ww          , Ww          , Wwr         , Wwr         , Ww          , Ww          , Gs^Efm      , Gs^Fms      , Gs^Fms      , Gs          , Gs          , Gs          , Gs          , Gs          , Gs          , Rr          , Gs          , Gs          , Gs^Fms      , Gs^Fms      , Gs^Fms      , Gs^Fms      , Gd          , Gd^Fms      , Gd^Fms      , Gd          
Gg          , Gg          , Gs^Fds      , Gs^Fds      , Gs^Fds      , Gg          , Gg          , Gg          , Ww          , Ww          , Ww          , Wwr         , Ww          , Ww          , Gs^Efm      , Gs          , Gs          , Gs          , Gs          , Gs          , Gs          , Gs          , Gs^Vhc      , Rr          , Gs^Fms      , Gs^Fms      , Gs^Fms      , Gs          , Gs^Fms      , Gs^Fms      , Gd^Fms      , Gd^Fms      , Gd          , Gd          
Gg          , Gs^Fds      , Gs^Fds      , Gg          , Gs^Fds      , Gs^Fds      , Gs^Fds      , Gg          , Ww          , Ww          , Ww          , Ww          , Ss^Efm      , Ww          , Gs          , Gs          , Gs          , Gs^Fms      , Gs^Fms      , Gs          , Gs          , Gs          , Rr          , Rr          , Gs^Fms      , Gs          , Gs^Fms      , Gs^Fms      , Gs          , Gd^Fms      , Gd          , Gd          , Gd          , Ds          
Rr          , Gg          , Gg          , Gs^Fds      , Gs^Fds      , Gs^Fds      , Gg          , Gg          , Ww          , Ww          , Ww          , Ss^Efm      , Gs^Fds      , Ww          , Ww          , Gs          , Gs^Fp       , Gs          , Gs^Fms      , Gs^Fms      , Gs          , Gs^Vhc      , Rr          , Gs          , Gs^Fms      , Gs^Fms      , Gs          , Gs          , Gd          , Gd          , Gd          , Gd          , Ds          , Ds          
Gg          , Rr          , Rr          , Rr          , Rr          , Gs^Fds      , Gs^Fds      , Gs^Fds      , Gg^Vhh      , Ww          , Gg          , Gg          , Gs^Fds      , Gg          , Gg          , Ww          , Gs^Vhc      , Gs^Fp       , Gs          , Gs^Fms      , Gs          , Rr          , Gs          , Gs          , Gs^Fms      , Gs          , Gs          , Gs          , Gd^Fms      , Gd^Fms      , Gd^Fms      , Ds          , Ds          , Ds          
Gs^Fds      , Gs^Fds      , Gs^Fds      , Gs^Fds      , Gs^Fds      , Rr          , Rr          , Gs^Fds      , Gs^Fds      , Gg          , Gs^Fds      , Gs^Fds      , Gs^Fds      , Gs^Fds      , Gg^Efm      , Ww          , Gs^Fp       , Gs          , Gs          , Gs          , Gs          , Rr          , Gs          , Gs^Fms      , Gs^Fms      , Gs^Fms      , Gs^Fms      , Gs^Fms      , Gd^Vhc      , Gd^Fms      , Gd          , Ds          , Ds          , Ds          
Gg          , Gs^Fds      , Ww          , Gg          , Ww          , Gs^Fds      , Gg          , Rr          , Rr          , Gs^Fds      , Gs^Fds      , Gs^Fds      , Gg          , Gg^Efm      , Ww          , Ww          , Ww          , Gs          , Gs          , Gs          , Gs          , Rr          , Gs          , Gs^Fp       , Gs^Vhc      , Gs^Fp       , Gs^Fp       , Gs^Fms      , Gs^Fms      , Gd          , Gd          , Ds          , Ds          , Ds          
Gg          , Gs^Fds      , Ww          , Ww          , Ww          , Ww          , Gg^Vhh      , Gg          , Rr          , Gs^Fds      , Gg          , Gg          , Ww          , Ww          , Ww          , Ww          , Ww          , Gs^Efm      , Gs^Efm      , Gs          , Rr          , Rr          , Gs^Fms      , Gs^Fp       , Gs^Fms      , Gs^Fms      , Gs^Fp       , Gs^Vhc      , Gs^Fms      , Gd          , Ds          , Ds          , Ds          , Ww          
Gg          , Ww          , Hhd^Fdw     , Hhd^Fdw     , Hhd^Fdw     , Ww          , Ww          , Rr          , Rr          , Gs^Fds      , Gg^Vhh      , Ww          , Ww          , Ww          , Gg^Efm      , Gg^Vh       , Gg^Efm      , Ww          , Gs^Efm      , Gs          , Rr          , Gs          , Gs          , Gs^Fms      , Gs^Fms      , Gs          , Gs          , Gs^Fms      , Gs^Fms      , Gd          , Ds          , Ds          , Ww          , Wo          
Ww          , Ww          , Hhd         , Hhd         , Hhd         , Hhd^Fdw     , Hhd^Fdw     , Ww          , Ww          , Rr          , Ww^Bw\r     , Ww          , Gs^Fp       , Gg          , Gs^Fp       , Gg^Efm      , Gg^Efm      , Ww          , Ww          , Gs^Fp       , Rr          , Gs          , Gs          , Gs^Fms      , Gs          , Gs          , Gs^Fms      , Gs^Fms      , Gs^Fms      , Gd          , Ds          , Ds          , Ww          , Wo          
Ww          , Hhd^Fdw     , Hhd^Fdw     , Hhd         , Hhd^Fdw     , Chr         , Chr         , Chr         , Ww          , Ww          , Ww^Ewl      , Rr          , Gs^Fp       , Gs^Fp       , Gg          , Gs^Fp       , Gg          , Ww          , Ww          , Gs^Fp       , Rr          , Gs^Fp       , Gs^Fp       , Gs^Fms      , Gs          , Gs          , Gs^Fms      , Gs^Fms      , Gs^Fms      , Gd          , Ds          , Ds          , Ww          , Wo          
Hhd^Fdw     , Hhd^Fdw     , Hhd         , Hhd         , Hhd^Fdw     , Khr         , Chr         , Chr         , Ww          , Ww          , Rr          , Rr          , Gs^Fp       , Gs^Fp       , Gs^Fp       , Gs^Fp       , Gg          , Gg          , Gs^Fp       , Ww          , Ww^Bw|      , Gs^Fp       , Gs^Fp       , Gs^Fms      , Gs          , Gs^Fms      , Gs^Fms      , Gs^Fms      , Gd^Fp       , Gd          , Ds          , Ds          , Ww          , Wo          
Hhd^Fdw     , Hhd^Fdw     , Hhd         , Hhd         , Chr         , Chr         , Chr         , Rr          , Rr          , Rr          , Gs^Fp       , Gs^Fp       , Gs^Fp       , Gg          , Gs^Fp       , Gs^Fp       , Gg          , Gs^Fp       , Gs^Fp       , Gs^Fp       , Rr          , Ww          , Gs^Vhc      , Gs^Fp       , Gs          , Gs          , Gd          , Gd^Fms      , Gd          , Gd          , Ds          , Ds          , Ww          , Wo          
Hhd         , Hhd         , Hhd         , Hh          , Gg          , Gs^Fp       , Gs^Fp       , Rr          , Gs^Fp       , Gs^Fp       , Gg          , Gg          , Gg          , Gg          , Gs^Fp       , Gg          , Gs^Fp       , Gg          , Gg          , Gs^Fp       , Rr          , Ww          , Gs          , Gs^Fp       , Gs          , Gs          , Ww          , Gd^Vhc      , Ds          , Ds          , Ds          , Ds          , Ww          , Wo          
Hhd^Fdw     , Hhd         , Hhd^Fdw     , Gg          , Gg^Vhr      , Gg          , Rr          , Rr          , Gg          , Gg          , Gs^Fp       , Gg          , Gs^Fp       , Gs^Fp       , Gs^Fp       , Gg          , Gs^Fp       , Gg          , Rr          , Rr          , Gs^Fp       , Ww          , Ss          , Ss          , Ww          , Ww          , Ww          , Gd          , Ds          , Ds          , Ds          , Ds          , Ww          , Wo          
Rr          , Hhd^Vhr     , Gg          , Gg          , Gs^Fp       , Rr          , Rr          , Gg          , Gs^Fp       , Gg          , Gs^Fp       , Gg          , Gg          , Gs^Fp       , Gg          , Gs^Fp       , Gg          , Rr          , Gg          , Gs^Fp       , Gs^Fp       , Ww          , Ww          , Ww          , Ss^Fp       , Ss^Vh       , Ww          , Ds          , Ds          , Ds          , Ds          , Ds          , Ww          , Wo          
Hh          , Rr          , Rr          , Gs^Fp       , Rr          , Rr          , Gg          , Gs^Fp       , Gs^Fp       , Gg          , Gs^Fp       , Gs^Fp       , Ww          , Gg^Vh       , Ww          , Gg          , Rr          , Rr          , Gg          , Gs^Fp       , Ww          , Ww          , Gs^Fds      , Ww          , Gs^Fds      , Gg          , Ww          , Ds          , Ds          , Ds          , Ds          , Ds          , Ww          , Wo          
Hh          , Gg          , Gg          , Rr          , Rr          , Gg          , Gs^Fp       , Gg^Vh       , Ww          , Gg^Vh       , Ww          , Ww          , Ww          , Ww          , Ww          , Chr         , Ww          , Gs^Fp       , Gg^Vh       , Gs^Fp       , Ww          , Ww          , Gs^Fp       , Gs^Fds      , Gs^Fds      , Gg          , Ww          , Ds          , Ds          , Ds          , Ww          , Dd^Vda      , Ww          , Wo          
Hh          , Hh          , Hh          , Gg          , Rr          , Gs^Fp       , Ww          , Ww          , Ww          , Ww          , Gs^Fds      , Ww          , Ww          , Gg          , Gg          , Rr          , Gs^Fds      , Ww          , Ww          , Ww          , Gg          , Gs^Fp       , Gs^Fp       , Gs^Fds      , Gs^Fds      , Gg^Vh       , Ww          , Dd^Vdt      , Ds          , Ds          , Ww          , Ww          , Ww          , Wo          
Hh          , Hh          , Hh          , Gs^Fp       , Ww          , Ww^Bw\      , Rr          , Gg          , Gg          , Gs^Fds      , Gg          , Gg          , Gg          , Gg          , Gg          , Rr          , Gs^Fds      , Gs^Fds      , Gg          , Ww          , Gg          , Gg          , Gs^Fp       , Gs^Fds      , Gs^Fds      , Gg          , Ww          , Ww          , Ww          , Ww          , Ds          , Ds          , Ww          , Wo          
Hh          , Hh          , Hh          , Gs^Fp       , Ww          , Ww          , Hh          , Rr          , Rr          , Gg          , Gg          , Gs^Fds      , Gs^Fds      , Gs^Fds      , Gg          , Rr          , Gs^Fds      , Gg          , Gg          , Gs^Fds      , Gs^Fds      , Gg          , Gg          , Gs^Fds      , Gs^Fds      , Gd^Fds      , Gd          , Ww          , Ds          , Ds          , Ds          , Ds          , Ww          , Wo          
Mm          , Hh          , Hh          , Ww          , Ww          , Hh          , Hh          , Gs^Fp       , Rr          , Gs^Fp       , Gs^Fp       , Gs^Fp       , Gs^Fp       , Gs^Fds      , Gg          , Rr          , Gg          , Gs^Fds      , Gg          , Gs^Fds      , Gs^Fds      , Gs^Fds      , Gg          , Gg          , Gs^Fds      , Gd^Fp       , Gd          , Gd          , Ds          , Ds          , Ds          , Ds          , Ww          , Wo          
Mm          , Mm          , Mm          , Ww          , Hh^Vht      , Hh          , Gg          , Gs^Fp       , Rr          , Gs^Fp       , Gg^Vc       , Gs^Fp       , Gs^Fp       , Gg^Vc       , Gs^Fp       , Rr          , Gg          , Gg^Vh       , Gg          , Gg          , Gg          , Gs^Fds      , Gs^Fds      , Gg          , Gd          , Gd^Fds      , Gd          , Gd          , Ds          , Ds          , Ds          , Ds          , Ww          , Wo          
Ww          , Mm          , Ww          , Ww          , Hh          , Hh          , Gg          , Gg          , Rr          , Gs^Fp       , Gs^Fp       , Gs^Fp       , Gs^Fp       , Gs^Fp       , Gs^Fp       , Rr          , Gg          , Gg          , Gs^Fds      , Gs^Fds      , Gg          , Gs^Fds      , Gg          , Gs^Fds      , Gd          , Gd^Fds      , Gd^Fds      , Gd          , Ds          , Ds          , Ds          , Ds          , Ww          , Wo          
Mm          , Ww          , Ww          , Ww          , Hh          , Gg          , Gg          , Gs^Fp       , Rr          , Gs^Fp       , Gs^Fp       , Gs^Fp       , Gg^Vc       , Gg          , Gg          , Rr          , Gg          , Gg          , Gs^Fds      , Gs^Fds      , Gs^Fds      , Gs^Fds      , Gs^Fds      , Gs^Fds      , Gd          , Gd          , Gd          , Gd          , Ds          , Ds          , Ds          , Dd^Vda      , Ww          , Wo          
Mm          , Mm          , Hh          , Hh          , Hh          , Gg          , Gg          , Gs^Fp       , Rr          , Gs^Fp       , Gs^Fp       , Ww          , Ww          , Gs^Fp       , Gg          , Rr          , Rr          , Gg          , Gs^Fds      , Gg          , Gs^Fds      , Gg          , Gg          , Gd          , Ww          , Ww          , Gd^Vht      , Gd          , Ds          , Ds          , Ww          , Ww          , Ww          , Wo          
Mm          , Hh          , Hh          , Hh          , Hh          , Gg          , Gs^Fp       , Gs^Fp       , Rr          , Ww          , Ww          , Ww          , Ww          , Gs^Fp       , Ww          , Gg          , Rr          , Gs^Fp       , Gs^Fds      , Gs^Fds      , Gg          , Gg          , Ww          , Ww          , Gg          , Ww          , Ww          , Ww          , Ww          , Ww          , Ww          , Ww          , Wo          , Wo          
Ww          , Hh          , Hh          , Hh          , Gs^Fp       , Gs^Fp       , Gs^Fp       , Gg          , Ww          , Chr         , Gs^Fp       , Gs^Fp       , Gs^Fp       , Ww          , Ww          , Gg^Vl       , Rr          , Gs^Fds      , Gs^Fp       , Gs^Fp       , Ww          , Ww          , Gg          , Gg          , Gd          , Gd^Vh       , Gd          , Ds          , Ds          , Ww          , Dd^Vda      , Ww          , Wo          , Wo          
Ww          , Hh          , Ww          , Hh          , Ww          , Gs^Fp       , Ww          , Gg          , Ww          , Rr          , Rr          , Gs^Fp       , Gs^Fp       , Gs^Fp       , Ww          , Ww          , Ww^Bw|      , Gg          , Gg^Vl       , Gg          , Ww          , Gg          , Gg          , Gs^Fp       , Gg          , Gd          , Gd^Fp       , Ds          , Ds          , Ds          , Ds          , Ww          , Wo          , Wo          
Ww          , Ww          , Ww          , Ww          , Ww          , Ww          , Gg          , Ww          , Gs^Fp       , Gg          , Gg          , Rr          , Gs^Fp       , Gs^Fp       , Gs^Fp       , Gs^Fp       , Rr          , Ww          , Ww          , Ww          , Gg          , Gg          , Gs^Fp       , Gs^Fp       , Gd^Fp       , Gd          , Ds          , Ds          , Ds          , Ds          , Ds          , Ww          , Wo          , Wo          
Ww          , Ww          , Ww          , Ww          , Ww          , Gg^Ve       , Gs^Fp       , Gs^Fp       , Gs^Fp       , Gg          , Gg          , Rr          , Gg          , Gs^Fp       , Gs^Fp       , Gs^Fp       , Rr          , Ww          , Ww          , Gg          , Gg          , Gs^Fp       , Gs^Fp       , Gd^Fp       , Gd          , Gd          , Ds          , Ds          , Ds          , Ds          , Ww          , Wo          , Wo          , Wo          
Ww          , Ww          , Ss          , Ww          , Ww          , Gg          , Gs^Fp       , Gs^Fp       , Gs^Fp       , Gg          , Gg          , Ch          , Ch          , Ch          , Rr          , Rr          , Gg          , Gg          , Gg          , Gg          , Gs^Fp       , Gs^Fp       , Gs^Fp       , Gd^Fp       , Gd          , Ds          , Ds          , Ds          , Ds          , Dd^Vda      , Ww          , Wo          , Wo          , Wo          
Ww          , Ss          , Gg          , Gg          , Gg          , Gg          , Gg          , Gg          , Gg          , Gg          , Gg          , Ch          , 2 Kh        , Ch          , Gg          , Gg          , Gg          , Gs^Fp       , Gs^Fp       , Gg          , Gs^Fp       , Gs^Fp       , Gs^Fp       , Gd          , Gd          , Ds          , Ds          , Ds          , Ds          , Ds          , Ww          , Wo          , Wo          , Wo          
Gs^Fp       , Gs^Fp       , Gs^Fp       , Gs^Fp       , Gs^Fp       , Gs^Fp       , Gg          , Gg          , Gg^Ve       , Gg          , Ch          , Ch          , Ch          , Ch          , Ch          , Gg          , Gg          , Gs^Fp       , Gg          , Gs^Fp       , Gs^Fp       , Gs^Fp       , Gs^Fp       , Gs^Fp       , Gd          , Gd          , Ds          , Ds          , Ds          , Ds          , Ds          , Ww          , Ds          , Ww          
Gg          , Gs^Fp       , Gg^Ve       , Gs^Fp       , Gs^Fp       , Gs^Fp       , Gs^Fp       , Gg          , Gg          , Gg          , Gg          , Gg          , Gg          , Gg          , Gg          , Rr          , Rr          , Gg          , Gg          , Gs^Fp       , Gs^Fp       , Gs^Fp       , Gs^Fp       , Gs^Fp       , Gs^Fp       , Gd          , Gd          , Ds          , Ds          , Ds          , Ds          , Ds          , Ds          , Ds          
Gg          , Gs^Fp       , Gs^Fp       , Gs^Fp       , Gs^Fp       , Gs^Fp       , Gs^Fp       , Gg          , Gs^Fp       , Gs^Fp       , Gs^Fp       , Gg          , Gs^Fp       , Gg          , Gs^Fp       , Gg          , Rr          , Gg^Ve       , Gs^Fp       , Gs^Fp       , Gs^Fp       , Gg^Ve       , Gs^Fp       , Gs^Fp       , Gs^Fp       , Gd^Fp       , Gd^Fp       , Gd          , Gd          , Ds          , Ds          , Ds          , Ds          , Ds          
Gg          , Gs^Fp       , Gs^Fp       , Gg          , Gg          , Gg^Ve       , Gs^Fp       , Gg          , Gs^Fp       , Gs^Fp       , Gs^Fp       , Gs^Fp       , Gs^Fp       , Gs^Fp       , Gs^Fp       , Gg          , Gs^Fp       , Rr          , Rr          , Rr          , Rr          , Gs^Fp       , Gg          , Gs^Fp       , Gs^Fp       , Gd^Fp       , Gd^Fp       , Gd^Fp       , Gd^Fp       , Gd          , Gd^Fp       , Ds          , Gd          , Ds          
Gg          , Gs^Fp       , Gg          , Gg          , Gs^Fp       , Gs^Fp       , Gg          , Gs^Fp       , Gg          , Gs^Fp       , Gg          , Gs^Fp       , Gg          , Gs^Fp       , Gs^Fp       , Gs^Fp       , Gg          , Gs^Fp       , Gs^Fp       , Gs^Fp       , Rr          , Gs^Fp       , Gs^Fp       , Gs^Fp       , Gs^Fp       , Gs^Fp       , Gs^Fp       , Gd^Fp       , Gd^Fp       , Gd^Fp       , Gd^Fp       , Gd          , Gd          , Gd          
