border_size=1
usage=map

Ms^Xm       , Ms^Xm       , Ms^Xm       , Ms^Xm       , Ms^Xm       , Ms^Xm       , Ms^Xm       , Ms^Xm       , Ms^Xm       , Ms^Xm       , Ms^Xm       , Ms^Xm       , Ms^Xm       , Ms^Xm       , Ms^Xm       , Ms^Xm       , Ms^Xm       , Ms^Xm       , Ms^Xm       , Ms^Xm       , Ms^Xm       , Ms^Xm       , Ms^Xm       , Ms^Xm       , Ms^Xm       , Ms^Xm       , Ms^Xm       , Ms^Xm       , Ms^Xm       , Ms^Xm       
Ms^Xm       , Ms^Xm       , Ms          , Ms^Xm       , Ms          , Ms          , Ms          , Ms          , Ms          , Ms          , Ms          , Ms          , Ms          , Ms          , Ms          , Ms^Xm       , Ms          , Ms^Xm       , Ms          , Ms^Xm       , Ms          , Ms          , Ms          , Ms          , Ms          , Ms          , Ms          , Ms^Xm       , Ms          , Ms^Xm       
Ms          , Ms          , Ms          , Ms          , Ms          , Ms          , Ms^Voa      , Ms          , Ms          , Ms          , Ms          , Ms          , Ms          , Ms          , Ms          , Ms          , Ms          , Ms          , Ms          , Ms          , Ms          , Ms          , Ms          , Ms          , Ms          , Ms          , Ms          , Ms          , Ha^Fda      , Ms          
Ms          , Ms          , Ms          , Ms          , Ms          , Ms          , Ms          , Ms          , Ms          , Ms          , Ms          , Ms          , Ms          , Ms          , Ms          , Ms          , Ms          , Ms          , Ha^Vhha     , Ms          , Ha          , Ha          , Coa         , Coa         , Coa         , Ms          , Ms          , Ha^Fda      , Ha^Fda      , Ha^Fda      
Ha          , Ha^Voa      , Ha^Fma      , Ha^Fma      , Ha^Fma      , Ha^Fma      , Ha          , Ha          , Ha          , Ha^Vaa      , Ha^Fma      , Ms          , Ms          , Ms          , Ms          , Ms          , Ha^Fma      , Ha^Fma      , Ha^Fma      , Ha          , Ha          , Coa         , Coa         , 2 Koa       , Coa         , Coa         , Ha          , Ha          , Ha^Fda      , Ha^Fda      
Ha^Fda      , Ha^Fma      , Ha^Fpa      , Ha^Fma      , Ha          , Ha^Fma      , Ha^Fpa      , Ha          , Ai          , Ha          , Ha          , Ha          , Ha          , Ha          , Ha          , Ha          , Ha          , Ha          , Ha          , Ha          , Ha          , Ms          , Coa         , Coa         , Coa         , Mm          , Ha          , Ha          , Ha          , Ha          
Ha^Fda      , Ha^Fda      , Ha^Fda      , Ha^Fpa      , Ha^Fpa      , Ha          , Ai          , Ai          , Ai          , Ai          , Ai          , Ha^Fpa      , Ha          , Ha          , Aa^Fpa      , Ha          , Ms          , Ha          , Hhd         , Hhd^Fdw     , Hhd^Fdw     , Hhd^Fdw     , Hhd^Fdw     , Hhd^Fdw     , Hhd^Fdw     , Mm          , Re          , Ha^Fda      , Re          , Ha          
Ha^Fda      , Ha^Fda      , Ha^Fda      , Ha^Fpa      , Ha^Fpa      , Ha          , Ai          , Ai          , Ai          , Ai          , Ai          , Ai          , Ms          , Ms          , Ms          , Ms          , Hhd^Vhhr    , Ha          , Hhd         , Hhd         , Hhd         , Hhd         , Hhd         , Hhd         , Re          , Re          , Mm          , Re          , Mm          , Re          
Aa^Fma      , Ha^Fda      , Ha^Fpa      , Ha^Fpa      , Ha^Fpa      , Ha          , Ai          , Ai          , Ai          , Ai          , Ha^Fpa      , Ha          , Ha          , Ms          , Ms          , Hhd         , Hhd         , Re          , Re          , Re          , Re          , Re          , Re          , Re          , Mm          , Mm          , Mm          , Mm          , Mm          , Mm          
Aa^Fma      , Aa^Fma      , Aa^Fma      , Aa^Fma      , Aa^Fma      , Ha          , Aa          , Ai          , Aa          , Ha^Fpa      , Aa^Fpa      , Aa^Fpa      , Aa^Fpa      , Aa^Fpa      , Hhd         , Hhd         , Hhd         , Hhd^Fdw     , Hhd^Fdw     , Hhd         , Re          , Re          , Hhd         , Hhd         , Mm          , Mm          , Mm          , Mm          , Mm          , Mm          
Aa^Fma      , Aa^Fma      , Aa^Fma      , Aa^Fma      , Aa^Fma      , Aa^Fma      , Aa          , Aa          , Aa^Fma      , Aa^Fma      , Aa^Fpa      , Aa^Fpa      , Aa^Fpa      , Aa^Fpa      , Re          , Hhd         , Hhd         , Hhd^Fdw     , Hhd         , Hhd^Fdw     , Re          , Re          , Hhd         , Hhd         , Mm^Vhha     , Mm          , Ms          , Ms          , Ms          , Ms          
Ha          , Ha          , Ha          , Ha          , Ha          , Aa          , Ms^Xm       , Aa^Fma      , Aa^Fma      , Aa^Fma      , Hhd^Fdw     , Aa^Fma      , Hhd         , Re          , Re^Fmw      , Re          , Re          , Re          , Re          , Re          , Re^Dr       , Re^Fmw      , Hhd         , Hhd         , Mm          , Ms          , Ms          , Ms          , Ms^Xm       , Ms          
Ha          , Ha          , Ms          , Ms          , Ms^Xm       , Ms^Xm       , Ms^Xm       , Ms^Xm       , Ms^Xm       , Hhd^Fdw     , Hhd         , Hhd^Fdw     , Hhd         , Hhd         , Hhd         , Hhd^Fdw     , Hhd         , Hhd         , Hhd         , Re          , Re          , Hhd         , Hhd         , Hhd         , Hhd^Fdw     , Ms          , Ms^Xm       , Ms^Xm       , Ms^Xm       , Ms          
Ha          , Ha          , Ms          , Ms          , Ms          , Ms^Xm       , Ha^Vca      , Ms          , Ms          , Ms^Xm       , Ms^Xm       , Hhd         , Ms^Xm       , Hhd         , Hhd^Fdw     , Hhd         , Hhd^Fdw     , Hhd         , Hhd         , Hhd         , Re^Fmw      , Re          , Hhd         , Hhd^Fdw     , Hhd^Fmw     , Ms          , Ms          , Ms^Xm       , Ms          , Ms          
Ms^Xm       , Ha          , Ha          , Cea         , Ha          , Ha          , Ha          , Ha          , Ha          , Ms          , Ha          , Ms^Xm       , Ms^Xm       , Ms^Xm       , Ms^Xm       , Hhd^Fdw     , Hhd^Vca     , Hhd^Fdw     , Hhd         , Hhd         , Re          , Re          , Hhd         , Hhd^Fmw     , Ha          , Ms          , Ha          , Ms          , Ha          , Ha          
Ms^Xm       , Ms^Xm       , Ms^Xm       , Ha          , Ms          , Ha          , Ha          , Ha          , Ha          , Ha          , Ha          , Ha          , Ha          , Ha          , Ha          , Ms^Xm       , Ms^Xm       , Hhd         , Hhd         , Cea         , Re          , Re^Fmw      , Hhd         , Hhd^Fmw     , Aa          , Ha          , Aa^Fma      , Ha          , Ha^Vla      , Ha          
Hhd         , Ms^Xm       , Ms^Xm       , Ms^Xm       , Ms          , Ms          , Ms          , Ha          , Ha          , Ha          , Ha          , Ha          , Ha          , Ha          , Ha          , Ha          , Ms^Xm       , Ms^Xm       , Re^Fmw      , Re^Fmw      , Re          , Cea         , Hhd^Fmw     , Hhd^Fmw     , Aa          , Aa          , Aa^Fma      , Aa^Fma      , Aa^Fma      , Aa^Fma      
Hhd         , Hhd         , Hhd         , Hhd         , Cha         , 1 Kha       , Cha         , Ms          , Cha         , Ha          , Ms          , Ms          , Ha          , Ha          , Ha          , Ha          , Rb          , Rb          , Rb          , Re          , Re          , Hhd         , Hhd^Fmw     , Aa^Fma      , Aa^Fma      , Aa^Fma      , Aa^Fma      , Aa^Fma      , Aa^Fma      , Aa^Fma      
Hhd^Fmw     , Hhd^Fmw     , Hhd^Fmw     , Hhd^Fmw     , Rb^Fmw      , Cha         , Cha         , Cha         , Cha         , Cha         , Mm          , Ms          , Ms          , Ha          , Rb          , Rb          , Rb          , Rb          , Rb          , Rb          , Re          , Re          , Re          , Aa^Fma      , Aa^Fma      , Aa^Fma      , Ai          , Ai          , Ai          , Aa^Fma      
Hhd^Fmw     , Hhd^Fmw     , Hhd^Fmw     , Rb^Fmw      , Rb^Fmw      , Rb^Fmw      , Rb^Fmw      , Mm          , Rb^Fmw      , Mm          , Rb          , Rb          , Rb          , Rb          , Rb          , Rb          , Rb          , Rb          , Rb          , Rb          , Rb^Fmw      , Re          , Re          , Aa^Fma      , Aa^Fma      , Aa^Fma      , Ai          , Ai          , Aa^Fma      , Aa^Fma      
Hhd^Fmw     , Hhd^Fmw     , Hhd^Fmw     , Rb^Fmw      , Rb          , Rb^Fmw      , Rb          , Rb^Fmw      , Rb          , Rb^Fmw      , Rb          , Rb          , Rb          , Rb          , Rb          , Rb          , Rb          , Rb          , Rb          , Rb^Fmw      , Rb^Fmw      , Rb^Fmw      , Aa          , Aa^Fma      , Aa^Fma      , Aa^Fma      , Ms          , Ms          , Ms          , Ms          
Hhd^Fmw     , Hhd^Fmw     , Rb          , Rb          , Rb          , Rb          , Rb          , Rb          , Rb          , Rb          , Rb          , Rb          , Rb^Fmw      , Rb          , Rb^Fmw      , Rb          , Rb^Fmw      , Rb^Fmw      , Rb^Fmw      , Rb^Fmw      , Rb^Fmw      , Rb^Fmw      , Aa          , Aa^Fma      , Aa^Vea      , Ms          , Ms          , Ms          , Ms^Xm       , Ms^Xm       
Hhd^Fmw     , Hhd^Fmw     , Rb          , Rb          , Rb          , Rb          , Rb          , Rb          , Rb          , Rb          , Rb          , Rb^Fmw      , Rb^Fmw      , Rb^Fmw      , Rb^Fmw      , Rb^Fmw      , Rb^Fmw      , Rb^Fmw      , Rb^Fmw      , Rb^Fmw      , Rb^Fmw      , Rb^Fmw      , Rb^Fmw      , Aa          , Ms          , Ms          , Ms          , Ms          , Ms^Xm       , Ms^Xm       
